1111111111111
1000100000001
1000001111001
100011E000001
10001100C0001
1000110000001
1000110000001
1P00110002301
1111111111111
