11111111111111111
10001000000011111
10000011110011111
100011E0000011111
10M01100C00011111
1000110M000011111
1P001100023011111
10001100000011111
10001100000011111
11111111111111111
