11111111111111
10001000000011
10000111110011
1P0011E0000011
1P0011E0000011
1P0011E0000011
1P0011E0000011
1P0011E0023011
11111111111111
