1111111111111
1000100000001
1000011111001
1001001000001
10001100C0001
1P00011002301
1000100000001
1000011111001
1111111111111
