1111111111111
10000000C0001
10C0011111001
100001E000001
10M00100C0001
1000010M00001
1P00010000001
100001000C001
1000010000001
1000010000001
1111111111111
