1111111111111
1000100000001
1000011111001
1P0011E000001
1P0011E0C0001
1P0011E000001
1P0011E0C0001
1P0011E002301
1111111111111
