11111111111111111
10001000C00011111
10C00011110011111
100011E0000011111
10M01100C00011111
1000110M000011111
1P001100000011111
100011000C0011111
10001100000011111
11111111111111111
