1111111111
10000001E1
1010100111
1P1C1CCCC1
1111111111
