1111111111
1CCCCCCCE1
1CCCCCCCC1
1PCCCCCCC1
1111111111
