1111111111
10000000E1
10101E0001
1P1C1CCCC1
1111111111
