1111111111
1P000000E1
1010100001
1P1C1CCCC1
1111111111
