1111111111
1000000001
1010100001
1P1C1CCCC1
1111111111
