11111111111111111111111111111111111111111111111111
1P0000000000000000000000000000000000000000000000E1
10001111111111111111111111111111111111111111111001
1C0000000000000000000000000000000000000000000000C1
11111111111111111111111111111111111111111111111111
1C0000000000000000000000000000000000000000000000C1
10001111111111111111111111111111111111111111111001
1C0000000000000000000000000000000000000000000000C1
11111111111111111111111111111111111111111111111111
1C0000000000000000000000000000000000000000000000C1
10001111111111111111111111111111111111111111111001
1C0000000000000000000000000000000000000000000000C1
11111111111111111111111111111111111111111111111111
1C0000000000000000000000000000000000000000000000C1
10001111111111111111111111111111111111111111111001
1C0000000000000000000000000000000000000000000000C1
11111111111111111111111111111111111111111111111111
1C0000000000000000000000000000000000000000000000C1
11111111111111111111111111111111111111111111111111
