1111111111
10000000E1
1010100000
1P1C1CCCC1
1111111111
