11111
1111111111
10000000E11
10101000011
1P1C1CCCC11
1111111111
11
