1111111111
10000000E1
1011111111
1P1C1CCCC1
1111111111
