1111111111
10000000E1
1010100001
1P10100001
1111111111
