111111111
1111P1111
111101111
111101111
1000C0001
111101111
111101111
1111E1111
111111111