0000000000
00000000E0
0010100000
0P1C1CCCC0
0000000000
