1111111111111111111111111111111111111111
10000000000000000000000000000000000000E1
1010100000000000000000000000000000000001
1P1C1CCCC0000000000000000000000000000001
1010100000000000000000000000000000000001
1010100000000000000000000000000000000001
1010100000000000000000000000000000000001
1010100000000000000000000000000000000001
1010100000000000000000000000000000000001
1010100000000000000000000000000000000001
1010100000000000000000000000000000000001
1010100000000000000000000000000000000001
1010100000000000000000000000000000000001
1010100000000000000000000000000000000001
1010100000000000000000000000000000000001
1010100000000000000000000000000000000001
1010100000000000000000000000000000000001
1010100000000000000000000000000000000001
1010100000000000000000000000000000000001
1010100000000000000000000000000000000001
1111111111111111111111111111111111111111