1111111111
10000000E1
1010100001
101C1CCCC1
1111111111
